# # # # # # # # # # i # # # # # # # # # # # # #
#             #   #       #       #   # . # . #
#   # # # #   #   #   #   #   #           #   #
#   # .       #   #   #   #   # # # # # # #   #
#   # # # # # #   #   #   #                   #
#                 # . #   # # # # #   # # # # #
# # # # # #   #   # # #                       #
#       . #   #   #   #   # # # # # # # # #   #
#   # # # #   # # #   #       # . #           #
#                     #   #   #   #   # # # # #
# # # # # # # # # #   #   #   #       # . #   #
# .               #   #   #   #   # # #       #
# # # #   # # # # #   #   #   #   #   #   #   #
#                         #   #           #   #
# # # # # # # # # # # # # # # # # # # # # #   #
                                            o  